AA=OF EACH
AC=BEFORE A MEAL
A.C=BEFORE A MEAL	
AD=RIGHT EAR
A.L=LEFT EAR
A.S=LEFT EAR
A.D=RIGHT EAR
A.T.C=AROUND THE CLOCK
ATC=AROUND THE CLOCK
AD LIB=USE AS MUCH AS ONE DESIRES
ADM=ADMINISTER
AEA=IN AFFECTED EAR(S)
AEY=IN AFFECTED EYE(S)
AIDO=AFTER INITIAL DOSE
ALT=ALTERNATE
AMP=AMPULE
AMT=AMOUNT
AOS=AT ONSET
AOW=APPLY ON WOUND
AP=APLICAR
AQ=AQUA
APL=APPLICATORFUL
APP=APPLY
APR=APPLY TO RASH
APS=APPLICATORSFUL
ASD=APPLY SPARINGLY WITH EACH DIAPER CHANGE
ATN=AT NIGHT
AVN=USE 1 AMPULE VIA NEBULIZER
B.T=BEDTIME
BT=BEDTIME
BID=TWICE DAILY
BD=TWICE DAILY
BDS=TWICE DAILY
B.D=TWICE DAILY
B.D.S=TWICE DAILY
B.I.D=TWICE DAILY
B.I.S=TWICE
BIS=TWICE
BUCC=INSIDE CHEEK
BP=BLOOD PRESSURE
BYT=WASH MOUTH WITH THE LIQUID
C=CAPSULE
CA=CAPSULA
CAS=CAPSULAS
CFL=CAPFUL
CNC=COUGH AND CONGESTION
CNTS=CONTENTS OF 1 PACKET
COG=CONGESTION
CONS=CONSECUTIVE
COU=FOR COUGH
CRU=CRUSH
CS=CAPSULES
CSW=CHEW AND SWALLOW
D=DAY
DAPP=DENTAL APPOINTMENT
DH=DIARRHEA
DI=DIARIAMENTE
DID=TWO OR THREE TIMES DAILY FOR WEIGHT LOSS
DIS=DISSOLVE
DPS=DROPPERSFUL
DR=DISCARD REMAINDER
DRK=DRINK
DRP=DROPPERFUL
DTI=DOUBLE OR TRIPLE FOR ILLNESS
EC=EACH CHEEK
EVE=EVENING
EXT=EXTERNALLY
FEV=AS NEEDED FOR FEVER
FEVP=AS NEEDED FOR FEVER AND PAIN
FID=FIVE TIMES DAILY
FPD=FOLLOW PACKAGE DIRECTIONS
FRI=FRIDAY
G=GIVE
GEF=GENERIC EQUIVALENT FOR
GEQ=GENERIC EQUIVALENT TO
GF=GENERIC FOR
GM=APPL
GMK=APPL
GSM=GENERIC SUBSTITUTION MADE
GTB=GTUBE
GTS=DROPS
GTT=DROP
H=HOUR
HA=HEADACHE
HS=AT BEDTIME
H.S=AT BEDTIME
N.P.O=NOTHING BY MOUTH
NPO=NOTHING BY MOUTH
I=INSERT
IEN=IN EACH NOSTRIL
IM=INTRAMUSCULAR
IMM=IMMEDIATELY
IN.=INTRANASAL
INJ=INJECT
INL=INHALE
INT=INSTILL
IVB=INSERT ONE APPLICATORFUL VAGINALLY AT BEDTIME
IVS=INSERT ONE SUPPOSITORY VAGINALLY AT BEDTIME
JTB=JTUBE
LEA=IN THE LEFT EAR
LEY=IN THE LEFT EYE
LOZ=LOZENGE
LQ=LIQUID
MCD=MAY CAUSE DROWSINESS
MDD=MAXIMUM DAILY DOSE IS
MEQ=MEQ
MIN=MINUTES
MON=MONDAY
MX=MIX
MXC=MIX 1 CAPFUL
N=OR NAUSEA
NEB=NEBULIZER
NER=FOR NERVES
NGTB=NG-TUBE
NM3=NO MORE THAN 3,000MG OF ACETAMINOPHEN DAILY
NM4=NO MORE THAN 4,000MG OF ACETAMINOPHEN DAILY
NOS=NOSTRIL
NTS=NIGHTS
NV=FOR NAUSEA AND VOMITING
OC=1 D FOR A FULL CYCLE. STOP FOR 1 WEEK, THEN REPEAT
OD=RIGHT EYE
O.D=RIGHT EYE
OES=ON AN EMPTY STOMACH
OS=LEFT EYE
OU=BOTH EYES
O.U=BOTH EYES
AU=BOTH EARS
A.U=BOTH EARS
P=FOR PAIN
PA=PATCH
PC=AFTER A MEAL
P.C=AFTER A MEAL
PFS=PUFFS
PO=BY MOUTH
P.O=BY MOUTH
PR=RECTALLY
P.R=RECTALLY
PRA=AS NEEDED FOR ANXIETY
PRF=AS NEEDED FOR
PRN=AS NEEDED
P.R.N=AS NEEDED
Q=EVERY
OM=EVERY MORNING
O.M=EVERY MORNING 
O.N=EVERY NIGHT
QAM=EVERY MORNING 
Q.A.M=EVERY MORNING
QD=EVERY DAY
Q.D=EVERY DAY
Q.Q.H=EVERY FOUR HOURS
QQH=EVERY FOUR HOURS
QDW=4 DAYS A WEEK
Q.D.W=4 DAYS A WEEK
QHS=EVERY NIGHT AT BEDTIME
QID=FOUR TIMES DAILY
Q.I.D=FOUR TIMES DAILY
QDS=FOUR TIMES DAILY
Q.D.S=FOUR TIMES DAILY
QOD=EVERY OTHER DAY
Q.O.D=EVERY OTHER DAY
QAD=EVERY OTHER DAY
Q.A.D=EVERY OTHER DAY
QPM=EVERY EVENING
Q.P.M=EVERY EVENING
QH=EVERY HOUR
Q.H=EVERY HOUR
ALT. H=EVERY OTHER HOUR
ALT H=EVERY OTHER HOUR
AMM=AT DOCTORS HAND
A.M.M=AT DOCTORS HAND
Q2H=EVERY 2 HOURS
Q.2.H=EVERY 2 HOURS
Q4H=EVERY 4 HOURS
Q.4.H=EVERY 4 HOURS
Q6H=EVERY 6 HOURS
Q.6.H=EVERY 6 HOURS
Q8H=EVERY 8 HOURS
Q.8.H=EVERY 8 HOURS
QWK=EVERY WEEK
Q.W.K=EVERY WEEK
QMO=EVERY MONTH
Q.M.O=EVERY MONTH
R=RECTAL
RE=REMOJAR
REP=REPEATS
REPT=REPEATS
REA=IN THE RIGHT EAR
REC=RECTALLY
REY=IN THE RIGHT EYE
RF=REFRIGERATE
RVN=USE 1 RESPULE VIA NEBULIZER
SAS=SWISH AND SWALLOW
SAT=SATURDAY
SLP=SLEEP
SML=SMALL
SND=SUNDAY
SOA=SOAK
SOB=SHORTNESS OF BREATH
SPR=SPRAY
SPS=SUPPOSITORIES
SQ=SUBCUTANEOUS
SUBC=SUBCUTANEOUS
SUBCUT=SUBCUTANEOUS
SQ=SUBCUTANEOUS
SC=SUBCUTANEOUS
SUBQ=SUBCUTANEOUS
SS=ONE-HALF
SU=SUPOSITORIO
SUP=SUPPOSITORY
SUS=SUPOSITORIOS
SW=SHAKE LIQUID WELL
SWR=SHAKE WELL AND REFRIGERATE
T=TABLET
TA=TABLETA
TAS=TABLETAS
TAT=UNTIL ALL TAKEN
TAY=TODAY
TBL=TABLESPOONFUL
T.D.W=3 DAYS A WEEK
TDW=3 DAYS A WEEK
TEA=TEASPOONFUL
TEL=TELUGU
TELG=TELUGU
TES=TEASPOONSFULL
THUR=THURSDAY
TID=THREE TIMES DAILY
T.I.D=THREE TIMES DAILY
TDS=THREE TIMES DAILY
T.D.S=THREE TIMES DAILY
T.I.W=THREE TIMES A WEEK
TIW=THREE TIMES A WEEK
TK=TAKE
TLS=TABLESPOONSFUL
TNT=ONE TABLET UNDER TONGUE AS NEEDED FOR CHEST PAIN
TS=TABLETS
TST=TEST
TUE=TUESDAY
TW=ONE TABLET IN WATER
U=USE
UNT=UNDER THE TONGUE
UNW=UNWRAP
UTD=AS DIRECTED
U.D=AS DIRECTED
UD=AS DIRECTED
VA=VAGINAL
VAG=IN THE VAGINA
VOM=VOMITING
VVN=USE 1 VIAL VIA NEBULIZER
WA=WHILE AWAKE
WC=WITH MEALS
WED=WEDNESDAY
WF=WITH FOOD
WFJ=WITH FRUIT JUICE
WHZ=WHEEZING
WKS=WEEKS
WOJ=WITH ORANGE JUICE
XD=TIMES DAILY
Q.S=A SUFFICIENT QUANTITY
QS=A SUFFICIENT QUANTITY
RX=PRESCRIPTION
SIG=DIRECTIONS
STAT=IMMIDIATELY
AAA=APPLY TO AFFECTED AREAS
B.M=BOWEL MOVEMENT
BM=BOWEL MOVEMENT
BOL=AS A LARGE SINGLE DOSE(USUALLY INTRAVENOUSLY)
B.S=BLOOD SUGAR
BS=BLOOD SUGAR
B.S.A=BODY SURFACE AREAS
BSA=BODY SURFACE AREAS
CRM=CREAM
CST=CONTINUE SAME TREATMENT
D.A.W=DISPENSE AS WRITTEN
DAW=DISPENSE AS WRITTEN
DIEB. ALT=EVERY OTHER DAY
DIEB ALT=EVERY OTHER DAY
DIL=DILUTE
DIV=DIVIDE
DL=DECILITER
D.T.D=GIVE OF SUCH DOSES
DTD=GIVE OF SUCH DOSES
D.W=DISTILLED WATER
DW=DISTILLED WATER
ELIX=ELIXIR
EMULS=EMULSION
EX AQ=IN WATER
ID=INTRADERMAL
IP=INTRAPERITONEAL
IT=INTRATHECAL
IV=INTRAVENOUS
IVP=INTRAVENOUVS PUSH
IVPB=INTRAVENOUVS PIGGYBACK
L.A.S=LABEL AS SUCH
LAS=LABEL AS SUCH
LIQ=SOLUTION
MANE=IN THE MORNING
MIN=MINIMUM
MIST=MIX
NOCT=AT NIGHT
NON REP=NO REPEATS
N.T.E=NOT TO EXCEED
NTE=NOT TO EXCEED
O.P.D=ONCE PER DAY
O.P.D=ONCE PER DAY
SID=ONCE A DAY
S.I.D=ONCE A DAY
PULV=POWDER
PV=VAGINALLY
SOL=SOLUTION
SUPP=SUPPOSITORY
SUSP=SUSPENSION
SYR=SYRUP
T.P.N=TOTAL PARENTERAL NUTRITION
TPN=TOTAL PARENTERAL NUTRITION
W/A=WHILE AWAKE
W/ A=WHILE AWAKE
W / A=WHILE AWAKE
Y.O=YEARS OLD
YO=YEARS OLD
AM=MORNING
A.M=MORNING
PM=EVENING
P.M=EVENING
CAP=CAPSULE
CAPS=CAPSULE
TAB=TABLET
TABS=TABLET
CIB=FOOD
CF=WITH FOOD
SL=SUBLINGUALLY
TBSP=TABLESPOON
TOP=TOPICAL
TR=TINCTURE
TINC=TINCTURE
TINCT=TINCTURE
TROCHE=LOZENGE
TSP=TEASPOON
UNG=OINTMENT