TO THE AFFECTED AREA=AA
BOTH=AB
BEFORE A MEAL=AC
RIGHT EAR=AD
ANTES DE LAS COMIDAS=ADC
ADD IT IN YOUR FOOD DIET=ADD
ADMINISTER=ADM
IN AFFECTED EAR(S)=AEA
IN AFFECTED EYE(S)=AEY
A LA HORA DE ACOSTARSE=AHA
AFTER INITIAL DOSE=AIDO
ALB=ALB
ALTERNATE=ALT
AMPULE=AMP
AMOUNT=AMT
AND=AND
AT ONSET=AOS
APPLY ON WOUND=AOW
APLICAR=AP
APPLICATORFUL=APL
APPLY=APP
APPLY TO RASH=APR
APPLICATORSFUL=APS
APPLY SPARINGLY WITH EACH DIAPER CHANGE=ASD
AROUND THE CLOCK=ATC
AT NIGHT=ATN
BOTH EARS=AU
USE 1 AMPULE VIA NEBULIZER=AVN
BEFORE=B
BEDTIME=BED
TWICE DAILY=BID
TWICE A DAY=BID
2 TIMES A DAY=BID
2 TIMES DAILY=BID
BOWEL MOVEMENT=BM
BLOOD PRESSURE=BP
BREAKFAST=BRE
WASH MOUTH WITH THE LIQUID=BYT
CAPSULE=C
CAPSULA=CA
TAKE ONE CAPSULE EVERY %1 HOURS=CAP
CAPSULAS=CAS
CAPFUL=CFL
CUCHARADA=CH
CUCHARADITA=CHD
COUGH AND CONGESTION=CNC
CONTENTS OF 1 PACKET=CNTS
CONGESTION=COG
CONSECUTIVE=CONS
FOR COUGH=COU
TAKE %1 CAPSULES EVERY %2 HOURS=CPS
CRUSH=CRU
CAPSULES=CS
CUANDO SEA NECESARIO= CSN
CHEW AND SWALLOW=CSW
CUATRO VECES AL DIA=CVD
DAILY=D
DENTAL APPOINTMENT= DAPP
DAYS=DAYS
DESPUES DE LAS COMIDAS=DDC
DIARRHEA=DH
DIARIAMENTE=DI
TWO OR THREE TIMES DAILY FOR WEIGHT LOSS=DID
DISSOLVE= DIS
DISSOLVE %1 TABLETS IN WATER=DIW
TK FOUR CS 1 HOUR B DAPP=DNC
TAKE FOUR TS 1 HOUR B DAPP=DNT
DROPPERSFUL=DPS
DISCARD REMAINDER=DR
DRINK=DRK
DROPPERFUL=DRP
DOUBLE OR TRIPLE FOR ILLNESS=DTI
DOS VECES AL DIA=DVD
EACH=EACH
EACH CHEEK=EC
TRGH=EEM
EN EL OJO DERECHO=EOD
EN EL OJO IZQUIERDO=EOS
EVENING=EVE
EXTERNALLY=EXT
AS NEEDED FOR FEVER=FEV
AS NEEDED FOR FEVER AND PAIN=FEVP
FIVE TIMES DAILY=FID
FIVE TIMES A DAY=FID
5 TIMES DAILY=FID
5 TIMES A DAY=FID
FIVE=FIVE
FOR=FOR
FOUR=FOUR
FOLLOW PACKAGE DIRECTIONS= FPD
FRIDAY=FRI
GIVE=G
GOTA=GA
GENERIC EQUIVALENT FOR=GEF
GENERIC EQUIVALENT TO=GEQ
GENERIC FOR=GF
APPL=GM
APPL=GMK
GENERIC SUBSTITUTION MADE=GSM
GTUBE=GTB
DROPS=GTS
DROP=GTT
HOURS=H
HEADACHE=HA
AT BEDTIME=HS
INSERT=I
IE10=IE10
IN EACH NOSTRIL=IEN
IN THE MUSCLE=IM
IMMEDIATELY=IMM
IN=IN
INHALE %1 PUFFS EVERY %2 HOURS=INH
INJECT=INJ
INHALE=INL
INSTILL=INT
INTO=INTO
INSERT ONE APPLICATORFUL VAGINALLY AT BEDTIME=IVB
INSERT ONE SUPPOSITORY VAGINALLY AT BEDTIME=IVS
JTUBE=JTB
IN THE LEFT EAR=LEA
IN THE LEFT EYE=LEY
LOZENGE=LOZ
LIQUID=LQ
MAY CAUSE DROWSINESS=MCD
MAXIMUM DAILY DOSE IS=MDD
MEAL=MEAL
MEQ=MEQ
MINUTES=MIN
ML=ML
MLS=MLS
MONDAY=MON
MIX=MX
MIX 1 CAPFUL=MXC
OR NAUSEA=N
NEBULIZER=NEB
FOR NERVES=NER
NEXT=NEXT
NG-TUBE=NGTB
NO MORE THAN 3,000MG OF ACETAMINOPHEN DAILY=NM3
NO MORE THAN 4,000MG OF ACETAMINOPHEN DAILY=NM4
NOSTRIL=NOS
NIGHTS=NTS
FOR NAUSEA AND VOMITING=NV
1 D FOR A FULL CYCLE. STOP FOR 1 WEEK, THEN REPEAT=OC
RIGHT EYE=OD
ON AN EMPTY STOMACH=OES
ONCE=ONCE
ONE=ONE
OR=OR
LEFT EYE=OS
BOTH EYES=OU
FOR PAIN=P
PATCH=PA
AFTER A MEAL=PC
PER=PER
PUFFS=PFS
PRIOR MEALS=PM
BY MOUTH=PO
PARA LA PRESION ARTERIAL=PPA
AS NEEDED FOR ANXIETY=PRA
AS NEEDED FOR=PRF
AS NEEDED=PRN
PARA USO EXTERNO=PUE
EVERY=Q
EVERY MORNING=QAM
EVERY DAY=QD
4 DAYS A WEEK=QDW
EVERY NIGHT AT BEDTIME=QHS
FOUR TIMES DAILY=QID
4 TIMES DAILY=QID
FOUR TIMES A DAY=QID
4 TIMES A DAY=QID
EVERY OTHER DAY=QOD
EVERY EVENING=QPM
RECTAL=R
REMOJAR=RE
IN THE RIGHT EAR=REA
RECTALLY=REC
IN THE RIGHT EYE=REY
REFRIGERATE=RF
USE 1 RESPULE VIA NEBULIZER=RVN
SWISH AND SWALLOW=SAS
SATURDAY=SAT
UNDER THE SKIN=SC
SEGUN INDICADO=SI
SIX=SIX
SLEEP=SLP
SMALL=SML
SUNDAY=SND
SOAK=SOA
SHORTNESS OF BREATH=SOB
SPRAY=SPR
SUPPOSITORIES=SPS
SUBCUTANEOUS=SQ
ONE -HALF=SS
SUPOSITORIO=SU
SUPPOSITORY=SUP
SUPOSITORIOS=SUS
SHAKE LIQUID WELL=SW
SHAKE WELL AND REFRIGERATE=SWR
TABLET=T
TABLETA=TA
TAKE ONE TABLET EVERY %1 HOURS=TAB
TABLETAS=TAS
UNTIL ALL TAKEN=TAT
TODAY=TAY
TABLESPOONFUL=TBL
TAKE %1 TABLETS EVERY %2 HOURS=TBS
TOME %1 CAPSULAS CADA %2 HORAS=TCH
CA UNA TA DEBAJO DE LA LENGUA CUANDO SEA NECESARIO=TDL
3 DAYS A WEEK=TDW
TEASPOONFUL=TEA
TELUGU=TEL
TELUGU=TELG
TEASPOONSFULL=TES
THEN=THEN
THURSDAY=THUR
THREE TIMES DAILY=TID
THREE TIMES A DAY=TID
3 TIMES DAILY=TID
3 TIMES A DAY=TID
TAKE=TK
TLS=TABLESPOONSFUL
TM=TOME
ONE TABLET UNDER TONGUE AS NEEDED FOR CHEST PAIN=TNT
TABLETS=TS
TEST=TST
TOME %1 TABLETAS CADA %2 HORAS=TTH
TUESDAY=TUE
TRES VECES AL DIA=TVD
ONE TABLET IN WATER=TW
TWO=TWO
USE=U
UNDER THE TONGUE=UNT
UNWRAP=UNW
UN DIA SI OTRO NO=USN
AS DIRECTED=UTD
VAGINAL=VA
IN THE VAGINA=VAG
VOMITING=VOM
USE 1 VIAL VIA NEBULIZER=VVN
WHILE AWAKE=WA
WITH MEALS=WC
WEDNESDAY=WED
WITH FOOD=WF
WITH FRUIT JUICE=WFJ
WHEEZING=WHZ
WITH=WITH
WEEKS=WKS
WITH ORANGE JUICE=WOJ
TIMES DAILY=XD